F 142,157,158
C 66,  135,245

NO                      textures/wolfenstein/purple_stone.xpm
    SO                      textures/wolfenstein/red_brick.xpm   
WE                      textures/wolfenstein/wood.xpm
EA                        textures/wolfenstein/color_stone.xpm

       111111111111111111111
       100000000000000000001
      100000000011000000001
     10000000001  10000001
    10000000001    100001
     100111111    10000001
      1001         100001
      101           1001
      101            101
      1011111111111111001
      1000000000000000001
       100000N0000000001
        111111111111111
