F 76,76,76
C 99,99,1

NO textures/wolfenstein/purple_stone.xpm
SO textures/wolfenstein/red_brick.xpm
WE textures/wolfenstein/wood.xpm
EA textures/wolfenstein/color_stone.xpm



      1111111111111    1111111111
11111110001111111 111111
1000000N001     1111111 1111
1000000000111111100001
111111111111111111111111111111111111



