F 76,76,76
C 99,99,99

NO textures/wolfenstein/purple_stone.xpm
SO textures/wolfenstein/red_brick.xpm
WE textures/wolfenstein/wood.xpm
EA textures/wolfenstein/color_stone.xpm

11111111111111111111111111111111111111111111111111111111111111111111111111111
10100000000010000000000001000000000000100000000000010000000000001000000000001
10101011111010111111100001011111110000101111111000010111111100001011111110001
10001011111000100000100000010000010000001000001000000100000100000010000010001
10111011111011111010111001111101011100111110101110011111010111001111101011101
10000011111010001010000001000101000000100010100000010001010000001000101000001
10111111111010111011111101011101111110101110111111010111011111101011101111111
10100000000010101000001001010100000100101010000010010101000001001010100000101
10101011111110101111101011010111110101101011111010110101111101011010111110101
10101000000010101000101001010100010100101010001010010101000101001010100010101
10111011111010101010101001010101010100101010101010010101010101001010101010101
10000011111010100010100001010001010000101000101000010100010100001010001010001
10111111111010011110111001011111011100101111101110010111110111001011111011101
10000000000010001000100001000100010000100010001000010001000100001000100010001
10111011111011101011101101110101110110111010111011011101011101101110101110111
10100011111000001000101000000100010100000010001010000001000101000000100010101
10111111111110111110101011111111010101111111101010111111110101011111111010101
1000000000000000000100000000000010000000000001000000000000100000000000010001
10001011111110111111111011011111111101101111111110110111111111011011111111101
1N000100000010000000000001000000000000100000000000010000000000001000000000001
11111111111111111111111111111111111111111111111111111111111111111111111111111
