F 76,76,N6
C 99,99,99

NO textures/wolfenstein/wood.xpm
SO textures/wolfenstein/red_brick.xpm
WE textures/wolfenstein/purple_stone.xpm
EA textures/wolfenstein/color_stone.xpm

1111111111111111111111
1000000000000000000001
1000000000000000000001
1000000000000000000001
1000000000000000000001
1000000000000000000001
1000000000000000000001
1000000000000000000001
100000000N000000000001
1000000000000000000001
1000000000000000000001
1000000000000000000001
1000000000000000000001
1000000000000000000001
1000000000000000000001
1000000000000000000001
1000000000000000000001
1000000000000000000001
1000000000000000000011
1111111111111111111111
