C 99,99,19
F 76,66,19

NO textures/wolfenstein/wood.xpm
SO textures/wolfenstein/red_brick.xpm
WE textures/wolfenstein/purple_stone.xpm
EA textures/wolfenstein/color_stone.xpm

1111111111111111111111
100000000N000000000001
1111111111111111111111
