F 76,76,76
C 99,99,99

NO textures/wolfenstein/purple_stone.xpm
SO textures/wolfenstein/red_brick.xpm
WE textures/wolfenstein/wood.xpm
EA textures/wolfenstein/color_stone.xpm


                                    11111
11111111111111111111111111111111111101111111111
100000000000000000000000000000000000N0000000001
11111111111111111111111111111111111111111111111
