F 76,76,76

NO textures/wolfenstein/purple_stone.xpm
SO textures/wolfenstein/red_brick.xpm
WE textures/wolfenstein/wood.xpm
EA textures/wolfenstein/color_stone.xpm

C 99,99,111
               1111111D11111    111111111
111111111111111100000000N00111111111111111111111
1111111111111100000000000000000111111111111111111
111111111111111110000000000000111111111111111
11111111111110000000011100000000011111111111
            1111011111 11111111111
              11111

